0,1,2,3,4,5,6,7,8,9,10,11,12,13,14,15
0,4,0,0,1,0,0,32,0,0,0,0,0,0,0,0
0,844,0,0,0,1,0,0,0,218,67,12,0,0,0,0
0,43,448,4,0,1,0,0,0,3,148,17,0,0,0,0
0,19,26,122,0,0,0,0,0,0,2,20,0,0,0,0
0,0,0,0,259,59,0,20,0,7,0,5,0,37,0,0
0,0,0,0,0,554,0,0,0,0,2,0,0,15,13,0
0,0,0,0,9,1,0,12,0,0,0,0,0,0,0,0
0,0,0,0,1,0,0,381,0,0,0,0,0,0,0,0
0,0,7,0,0,8,0,0,0,0,1,0,0,0,0,0
0,34,3,0,0,15,0,0,0,566,152,5,1,0,0,2
0,155,101,3,0,30,0,0,0,78,1561,30,3,0,2,2
0,94,144,5,0,1,0,0,0,46,21,158,4,0,0,2
0,0,8,0,0,41,0,0,0,3,1,8,45,0,58,0
0,0,0,0,3,0,0,0,0,0,0,2,3,958,46,0
0,0,0,0,0,28,0,0,0,0,0,0,6,51,220,3
0,0,0,0,0,0,0,0,0,2,0,0,0,0,0,73
